A-------------B
|P...........P|
|.A----.----B.|
|.|.........|.|
|.|.-------.|.|
|.|.........|.|
|.|.A-----B.|.|
|.|.Z12034Z.|X|
|.|.C-----D.|.|
|.|.........|.|
|.|.-------.|.|
|.|.........|.|
|.C----.----D.|
|P...........P|
C-------------D
