A---F-----F---B
|P..|..P..|..P|
|.|.|.|.|.|.|.|
|.|...|.|...|.|
|.H---E.E---G.|
|.|.........|.|
|...A-----B...|
|.|.Z12034Z.|.|
|...C-----D...|
|.|.........|.|
|.H---FXF---G.|
|.|...|.|...|.|
|.|.|.|.|.|.|.|
|P..|..P..|..P|
C---E-----E---D
