A-------------B
|P...........P|
|.#.|.|.|.|.#.|
|...|.|.|.|...|
|.--D.|.|.C--.|
|.............|
|.|.A-----B.|.|
|.|.Z12034Z.|.|
|.|.C-----D.|.|
|......X......|
|.--B.|.|.A--.|
|...|.|.|.|...|
|.#.|.|.|.|.#.|
|P...........P|
C-------------D
