A-------------B
|P...........P|
|.|.........|.|
|.C-B..#..A-D.|
|...|..#..|...|
|.A-D.....C-B.|
|.|#########|.|
|..ZZ12034ZZ..|
|.|#########|.|
|.C-B.....A-D.|
|...|..#..|...|
|.A-D..#..C-B.|
|.|.........|.|
|P.....X.....P|
C-------------D
