A-------------B
|P...........P|
|.|.-B.|.A-.|.|
|.|..|.|.|..|.|
|.H-.|.|.|.-G.|
|.|.........|.|
|.|.A-----B.|.|
|...Z12034Z...|
|.|.C-----D.|.|
|.|....X....|.|
|.H-.|.|.|.-G.|
|.|..|.|.|..|.|
|.|.-D.|.C-.|.|
|P...........P|
C-------------D
