A-------------B
|P...........P|
|.A.--------B.|
|.|.........|.|
|.c--------.D.|
|.............|
|.|.A-----B.|.|
|.|.Z12034Z.|.|
|.|.C-----D.|.|
|.............|
|.A--------.B.|
|.|.........|.|
|.C.--------D.|
|P.....X.....P|
C-------------D
