A-------------B
|P...........P|
|.A----.----B.|
|.............|
|.H-.-----.-G.|
|.............|
|.|.A-----B.|.|
|...Z12034Z...|
|.|.C-----D.|.|
|.............|
|.H-.-----.-G.|
|.............|
|.C----.----D.|
|P.....X.....P|
C-------------D
