A-------------B
|P...........P|
|...A--.--B...|
H--.|.....|.--G
|...|.AZB.|...|
|.--G.|1|.H--.|
|...|.|2|.|...|
|.#..X|0|...#.|
|...|.|3|.|...|
|.--G.|4|.H--.|
|...|.CZD.|...|
H--.|.....|.--G
|...C--.--D...|
|P...........P|
C-------------D
